R 500001 5oiadkj01
NO ./img/wood.xpm
SO img/metal.xpm
WE img/brick.xpm
EA img/stone.xpm
S img/s.xpm
F 145,144,144
C 45,93,131
        11111111111111111111111111
        1000000000110000000000001
        1011000001110000002000001
        1001000000000000000000001
11111111101100000111000000N000001
1000000000110000011101001111111111
11110111111111011100000010001
11110111111111011101010010001
11000000110101011100000010001
10002000000000001100000010001
10000000000000001101010010001
1100000111010101111101111000111
11110111 1110101 101111010001
11111111 1111111 111111111111
